{
	"map": [
		"#&&&&&&&&&&&&&&&&&&&&&&&&&&&&&&&&&&&&",
		"      &     &       &     &     &   &",
		"# &&& &&& &&& &&&&& &&& &&& &&& &&& &",
		"& &   &       &   &         &   &   &",
		"& & &&&&& &&&&& & &&&&& & &&&&& &&& &",
		"& &     & &     &     & & &     &   &",
		"& &&&&& & & &&&&&&&&& & & & &&&&& & &",
		"&     & & & &       & & & & &     & &",
		"&&&&& &&& & & &&&&& &&& & & & & &&& &",
		"&   &     & & &   &   & &   & &   & &",
		"& & &&&&& & & & & &&& & &&&&& &&& & &",
		"& &       &   & &   & &       &   & &",
		"& &&&&&&& &&&&& &&& & &&&&&&&&& &&&&&",
		"&       &       & & &         &     &",
		"&&&&& &&& &&& & & & &&&&&&&&& &&&&& &",
		"&     &   &   & & &     &   & &   & &",
		"& & & & &&& & & &&&&&&& & & & & & & &",
		"& & & & &   & &       & & & & & & & &",
		"& & &&& & &&&&&&&&&&& &&& & & & &&& &",
		"& &   & &     &   &   &   & & &   & &",
		"& &&& & &&&&& & & &&& &&&&& & &&& & &",
		"&     &     &   &   &       &     & &",
		"&&&&&&&&&&&&&&&&&&&&&&&&&&&&&&&&&&% %"
	],
	"spawnpoint":  [0.5,1.5]
}